20x20;

BB=nibbles~1~0,
PP=nibbles~2~0,
R1=nibbles~3~0,
R2=nibbles~4~0,
;

PP|PP|PP|PP|PP|PP|PP|PP|PP|PP|PP|PP|PP|PP|PP|PP|PP|PP|PP|PP|
PP|BB|BB|BB|BB|BB|BB|BB|BB|BB|BB|BB|BB|BB|BB|BB|BB|BB|BB|R1|
PP|BB|BB|BB|BB|BB|BB|BB|BB|BB|BB|BB|BB|BB|BB|BB|BB|BB|BB|R1|
PP|BB|BB|BB|BB|BB|BB|BB|BB|BB|BB|BB|BB|BB|BB|BB|BB|BB|BB|R1|
PP|BB|BB|BB|BB|BB|BB|BB|BB|BB|BB|BB|BB|BB|BB|BB|BB|BB|BB|R1|
PP|BB|BB|BB|BB|BB|BB|BB|BB|BB|BB|BB|BB|BB|BB|BB|BB|BB|BB|R1|
PP|BB|BB|BB|BB|BB|BB|BB|BB|BB|BB|BB|BB|BB|BB|BB|BB|BB|BB|R1|
PP|BB|BB|BB|BB|BB|BB|BB|BB|BB|BB|BB|BB|BB|BB|BB|BB|BB|BB|R1|
PP|BB|BB|BB|BB|BB|BB|BB|BB|BB|BB|BB|BB|BB|BB|BB|BB|BB|BB|R1|
PP|BB|BB|BB|BB|BB|BB|BB|BB|BB|BB|BB|BB|BB|BB|BB|BB|BB|BB|R1|
PP|BB|BB|BB|BB|BB|BB|BB|BB|BB|BB|BB|BB|BB|BB|BB|BB|BB|BB|R1|
PP|BB|BB|BB|BB|BB|BB|BB|BB|BB|BB|BB|BB|BB|BB|BB|BB|BB|BB|R1|
PP|BB|BB|BB|BB|BB|BB|BB|BB|BB|BB|BB|BB|BB|BB|BB|BB|BB|BB|R1|
PP|BB|BB|BB|BB|BB|BB|BB|BB|BB|BB|BB|BB|BB|BB|BB|BB|BB|BB|R1|
PP|BB|BB|BB|BB|BB|BB|BB|BB|BB|BB|BB|BB|BB|BB|BB|BB|BB|BB|R1|
PP|BB|BB|BB|BB|BB|BB|BB|BB|BB|BB|BB|BB|BB|BB|BB|BB|BB|BB|R1|
PP|BB|BB|BB|BB|BB|BB|BB|BB|BB|BB|BB|BB|BB|BB|BB|BB|BB|BB|R1|
PP|BB|BB|BB|BB|BB|BB|BB|BB|BB|BB|BB|BB|BB|BB|BB|BB|BB|BB|R1|
PP|BB|BB|BB|BB|BB|BB|BB|BB|BB|BB|BB|BB|BB|BB|BB|BB|BB|BB|R1|
PP|PP|PP|PP|PP|PP|PP|PP|PP|PP|PP|PP|PP|PP|PP|PP|PP|PP|PP|PP|
;

01|01|01|01|01|01|01|01|01|01|01|01|01|01|01|01|01|01|01|01|
01|00|00|00|00|00|00|00|00|00|00|00|00|00|00|00|00|00|00|01|
01|00|00|00|00|00|00|00|00|00|00|00|00|00|00|00|00|00|00|01|
01|00|00|00|00|00|00|00|00|00|00|00|00|00|00|00|00|00|00|01|
01|00|00|00|00|00|00|00|00|00|00|00|00|00|00|00|00|00|00|01|
01|00|00|00|00|00|00|00|00|00|00|00|00|00|00|00|00|00|00|01|
01|00|00|00|00|00|00|00|00|00|00|00|00|00|00|00|00|00|00|01|
01|00|00|00|00|00|00|00|00|00|00|00|00|00|00|00|00|00|00|01|
01|00|00|00|00|00|00|00|00|00|00|00|00|00|00|00|00|00|00|01|
01|00|00|00|00|00|00|00|00|00|00|00|00|00|00|00|00|00|00|01|
01|00|00|00|00|00|00|00|00|00|00|00|00|00|00|00|00|00|00|01|
01|00|00|00|00|00|00|00|00|00|00|00|00|00|00|00|00|00|00|01|
01|00|00|00|00|00|00|00|00|00|00|00|00|00|00|00|00|00|00|01|
01|00|00|00|00|00|00|00|00|00|00|00|00|00|00|00|00|00|00|01|
01|00|00|00|00|00|00|00|00|00|00|00|00|00|00|00|00|00|00|01|
01|00|00|00|00|00|00|00|00|00|00|00|00|00|00|00|00|00|00|01|
01|00|00|00|00|00|00|00|00|00|00|00|00|00|00|00|00|00|00|01|
01|00|00|00|00|00|00|00|00|00|00|00|00|00|00|00|00|00|00|01|
01|00|00|00|00|00|00|00|00|00|00|00|00|00|00|00|00|00|00|01|
01|01|01|01|01|01|01|01|01|01|01|01|01|01|01|01|01|01|01|01|
;