21x15;

NN=pong~0~1,
PP=pong~5~0,
LV=pong~8~0,
LH=pong~8~0~90,
E0=pong~6~0,
E1=pong~6~0~90,
E2=pong~6~0~-180,
E3=pong~6~0~-90,
CT=pong~7~0,
CB=pong~7~0~180,
;

NN|NN|NN|NN|NN|NN|NN|NN|NN|NN|PP|NN|NN|NN|NN|NN|NN|NN|NN|NN|NN|
E0|LH|LH|LH|LH|LH|LH|LH|LH|LH|CT|LH|LH|LH|LH|LH|LH|LH|LH|LH|E1|
LV|NN|NN|NN|NN|NN|NN|NN|NN|NN|LV|NN|NN|NN|NN|NN|NN|NN|NN|NN|LV|
LV|NN|NN|NN|NN|NN|NN|NN|NN|NN|LV|NN|NN|NN|NN|NN|NN|NN|NN|NN|LV|
LV|NN|NN|NN|NN|NN|NN|NN|NN|NN|LV|NN|NN|NN|NN|NN|NN|NN|NN|NN|LV|
LV|NN|NN|NN|NN|NN|NN|NN|NN|NN|LV|NN|NN|NN|NN|NN|NN|NN|NN|NN|LV|
LV|NN|NN|NN|NN|NN|NN|NN|NN|NN|LV|NN|NN|NN|NN|NN|NN|NN|NN|NN|LV|
LV|NN|NN|NN|NN|NN|NN|NN|NN|NN|LV|NN|NN|NN|NN|NN|NN|NN|NN|NN|LV|
LV|NN|NN|NN|NN|NN|NN|NN|NN|NN|LV|NN|NN|NN|NN|NN|NN|NN|NN|NN|LV|
LV|NN|NN|NN|NN|NN|NN|NN|NN|NN|LV|NN|NN|NN|NN|NN|NN|NN|NN|NN|LV|
LV|NN|NN|NN|NN|NN|NN|NN|NN|NN|LV|NN|NN|NN|NN|NN|NN|NN|NN|NN|LV|
LV|NN|NN|NN|NN|NN|NN|NN|NN|NN|LV|NN|NN|NN|NN|NN|NN|NN|NN|NN|LV|
LV|NN|NN|NN|NN|NN|NN|NN|NN|NN|LV|NN|NN|NN|NN|NN|NN|NN|NN|NN|LV|
LV|NN|NN|NN|NN|NN|NN|NN|NN|NN|LV|NN|NN|NN|NN|NN|NN|NN|NN|NN|LV|
E3|LH|LH|LH|LH|LH|LH|LH|LH|LH|CB|LH|LH|LH|LH|LH|LH|LH|LH|LH|E2|
;

00|00|00|00|00|00|00|00|00|00|00|00|00|00|00|00|00|00|00|00|00|
01|01|01|01|01|01|01|01|01|01|01|01|01|01|01|01|01|01|01|01|01|
01|00|00|00|00|00|00|00|00|00|00|00|00|00|00|00|00|00|00|00|01|
01|00|00|00|00|00|00|00|00|00|00|00|00|00|00|00|00|00|00|00|01|
01|00|00|00|00|00|00|00|00|00|00|00|00|00|00|00|00|00|00|00|01|
01|00|00|00|00|00|00|00|00|00|00|00|00|00|00|00|00|00|00|00|01|
01|00|00|00|00|00|00|00|00|00|00|00|00|00|00|00|00|00|00|00|01|
01|00|00|00|00|00|00|00|00|00|00|00|00|00|00|00|00|00|00|00|01|
01|00|00|00|00|00|00|00|00|00|00|00|00|00|00|00|00|00|00|00|01|
01|00|00|00|00|00|00|00|00|00|00|00|00|00|00|00|00|00|00|00|01|
01|00|00|00|00|00|00|00|00|00|00|00|00|00|00|00|00|00|00|00|01|
01|00|00|00|00|00|00|00|00|00|00|00|00|00|00|00|00|00|00|00|01|
01|00|00|00|00|00|00|00|00|00|00|00|00|00|00|00|00|00|00|00|01|
01|00|00|00|00|00|00|00|00|00|00|00|00|00|00|00|00|00|00|00|01|
01|01|01|01|01|01|01|01|01|01|01|01|01|01|01|01|01|01|01|01|01|
;